text	label	prediction
Après le palais du facteur nous voici à la halte qui est un restaurant correct.	neutral restaurant                                                                                                                             	 positive halte        
Le patron nous accueille très chaleureusement et c'est sa femme qui cuisine.	positive patron                                                                                                                             	 positive patron | positive femme      
Le prix est un peu élevé pour un repas qui n'a pas nécessité toute une implication du début à la fin.	negative repas                                                                                                                            	 negative repas        
Des pizzas locales que vous ne mangerez pas ailleurs, accommodant les spécialités du coin.	positive pizzas                                                                                                                            	 positive pizzas locales | positive pizzas locales
Très bon accueil	positive accueil                                                                                                                            	 positive accueil                 
Le cadre et le personnel sont agréables.	positive cadre | positive personnel                                                                                                                         	 positive cadre | positive personnel              
Par contre l'attente est interminable pour une salade dont la sauce est industrielle, et des ravioles dans un bain de crème pas cuite.	negative attente | negative ravioles | negative sauce | negative crème                                                                                                            	 negative salade | negative sauce | negative ravioles dans un bain de crème
Au centre de ce tout petit village, on ne s'attendait pas à manger aussi bien sur une terrasse agréable.	positive terrasse                                                                                                                             	 positive terrasse                  
Service plaisant.	positive Service                                                                                                                             	 positive Service             
Salade fanée, vin moyen, gratin de raviolis mangeable.	negative Salade | neutral vin | neutral gratin de raviolis                                                                                                                 	 positive Salade fanée | positive vin | positive gratin de raviolis
Bonnes glaces.	positive glaces                                                                                                                            	 positive glaces            
Terrasse négligée.	negative Terrasse                                                                                                                            	 negative Terrasse            
C'est dommage, l'emplacement est idéal et le service plutôt sympa mais ça ne fait pas tout!	positive emplacement | positive service                                                                                                                         	 positive emplacement | positive service | negative emplacement 
Si vous êtes en vacances, si vous avez –beaucoup- de temps à perdre tout en regardant les serveuses et serveurs (au demeurant charmants) virevolter comme des mouches ne sachant quoi faire ni pour qui faire (1 heure pour 3 côtelettes froides, et, le lendemain, 3⁄4 d’heures pour 3 glaces jamais arrivées...!), longue attente accompagnée par une musique horripilante (boum tchic, boum tchic, sans	negative serveuses | negative musique | negative attente | negative côtelettes | negative serveurs                                                                                                      	 positive serveuses | positive serveurs | negative musique
On est rassuré « la patronne, interpellée, va faire des enquêtes » (sic), bref c’est PARFAIT.	negative patronne                                                                                                                           	 positive patronne         
Dommage le cadre est sympa.	positive cadre                                                                                                                            	 positive cadre         
Un début de soirée qui commence dans un bon resto, comme les 1er fois une Virgin Colada à 6.50e pour se mettre en appétit et un accueil toujours très chaleureux du patron et de sa femme.	positive resto | positive accueil | positive patron | positive femme                                                                                                                   	 positive resto | positive Virgin Colada | positive accueil           
Le pavé de Saumon est extra mais pour changer je teste la poêlée de noix de st Jacques à 22euros avec en gratin du jour (pomme de terre et patate douce ) le mariage sympathique et frites.	positive pavé de Saumon | positive gratin du jour | positive poêlée de noix de st Jacques                                                                                                       	 positive pavé de Saumon | positive poêlée de noix de st Jacques | positive frites
Que du bonheur dans l'assiette, la cuisson de mes noix sont parfaites, légèrement nacrées à l'intérieur, moelleuses à souhait... la,sauce crème légère.	positive assiette | positive noix | positive sauce crème légère                                                                                                                	 positive assiette | positive cuisson de mes noix | positive sauce crème légère   
Je pars très satisfaite de mon plat très bon.	positive plat                                                                                                                             	 positive plat                    
Une adresse à mettre dans mon top five.	positive adresse                                                                                                                             	 positive adresse     
Bonne cuisine créole.	positive cuisine créole                                                                                                                           	 positive cuisine créole   
Le service est rapide et assez froid, mais les assiettes sont bien garnies.	neutral service | positive assiettes                                                                                                                         	 positive service | negative assiettes
Le restaurant se trouvant au-dessus du marché, l'ambiance est garantie.	positive ambiance | positive restaurant                                                                                                                         	 positive ambiance | positive restaurant 
L'apéro est étonnant : on vous sert une bouteille de 1 litre de rhum et une bouteille de sucre canne liquide.	neutral apéro                                                                                                                            	 negative apéro | negative rhum | negative sucre canne liquide
Un service impeccable et des cocktails ahurissant.	positive service | positive cocktails                                                                                                                         	 positive service | positive cocktails             
Mais le summum fut l'arrivée des entrées.	positive entrées                                                                                                                           	 positive entrées               
Le foi gras est le meilleur de l'île.	positive foi gras                                                                                                                            	 positive foi gras                
Le carpaccio de st jacques sauvages est divin.	positive carpaccio de st jacques sauvages                                                                                                                    	 positive carpaccio de st jacques sauvages       
Puis est arrivée la pluma de pata negra avec son incroyable purée a l'huile de truffe.	positive purée a l'huile de truffe                                                                                                                  	 positive purée a l'huile de truffe     
Merci rodolphe pour ce repas incroyable.	positive repas                                                                                                                             	 positive rodolphe              
"La carte est -au premier abord- plutôt attrayante, mais c'est sans compter sur l'indisponibilité de nombreux aliments (lambi, marlin et thon ce soir là), et les prix hallucinants d'autres (notamment les ""plateaux"" de fruits de mer, qui ne sont en fait que de petites assiettes)."	"positive carte | negative aliments | negative ""plateaux"" de fruits de mer | negative ""plateaux"" de fruits de mer | negative aliments                                                                                           "	 negative carte | negative lambi | negative marlin | negative thon
Mon choix s'est donc porté sur des pâtes aux fruits de mer (2 moules surcuites, 3 saint jacques décongelées, et beaucoup trop d'ail).	negative moules | negative saint jacques | negative pâtes aux fruits de mer                                                                                                          	 negative pâtes aux fruits de mer (2 moules surcuites | negative saint jacques décongelées | negative ail)
Salle très bruyante (on n'arrivait plus à s'entendre), mais service efficace.	positive service | negative Salle                                                                                                                        	 negative Salle | positive service                        
Le cadre est somptueux, le repas est très correct..	positive cadre | positive repas                                                                                                                         	 positive cadre | positive repas                         
De bonnes lasagnes et un café gourmand agréable..	positive lasagnes | positive café gourmand                                                                                                                      	 positive lasagnes | positive café gourmand                      
Mais si le service très décontracté est sympathique..	positive service                                                                                                                             	 positive service                  
Escalope milanaise panée sur un côté seulement et plein d'huile.	negative Escalope milanaise                                                                                                                         	 negative Escalope milanaise panée sur le côté seulement et plein d'huile
Entrecôte avec plus de nerfs que de viande et j'en passe.	negative Entrecôte                                                                                                                          	 negative Entrecôte avec plus de nerfs que de viande    
un resto qui ravira les papilles avec des produits très bien cuisinés.	positive produits                                                                                                                            	 positive resto | positive produits              
mais une catastrophe côté service : on a été oublié dans un coin, par contre, les tables de droite et de gauche ont eu droit à tous les égards (faut être américains ou famille nombreuse pour être intéressant faut croire!)	negative service                                                                                                                            	 negative service | positive tables de droite et gauche   
on n'a pas eu de seau à glace pour le vin blanc, pas de pain durant le repas, on a dû se lever pour interpeler les serveuses qui ne nous jetaient même pas un regard, on a énormément attendu entre les plats qu'on veuille bien daigner nous débarasser les assiettes vides... bref!	negative serveuses                                                                                                                           	 negative seau à glace pour le vin blanc | negative serveuses
L'endroit est très beau, l'assiette est divine, les vins bouleversants, ajoutez à cela l'enthousiasme contagieux du patron : que demander de plus?	positive endroit | positive assiette | positive vins                                                                                                                     	 positive endroit | positive assiette | positive vins | positive patron    
On est si bien à l'Art dit Vin, on y passe de bons moments :)	positive Art dit Vin                                                                                                                           	 positive Art dit Vin             
"accueil sympa par 2 sénior""e""s qui mettent à l'aise"	positive accueil                                                                                                                            	" positive accueil par 2 sénior""e""s       "
Le rapport qualité prix est au top avec une cuisine locale et une climatisation manuelle qui nécessite une explication	positive cuisine                                                                                                                             	 positive cuisine locale | positive climatisation manuelle        
Pour éviter une trop grosse demande incompatible avec leur taille de four, le souffle au grand margnier ne figure pas a la carte aussi prévoir de le commander en début de repas	neutral carte                                                                                                                             	 negative souffle au grand margnier | negative souffle au grand margnier 
Une originalité :les légumes sont comptés à part, sans doute pour ne pas renchérir le prix des plats	neutral légumes | neutral plats                                                                                                                         	 neutralité :les légumes sont comptés à part | negative plats
Un restaurant a l'ancienne qui a bien du charme	positive restaurant | positive restaurant                                                                                                                          	 positive restaurant ancienne               
Les fruits de mer en entrée étaient dégoûtants (sont-ils frais?).	negative fruits de mer                                                                                                                         	 negative fruits de mer en entrée           
Les chipirons à l'encre étaient sucrés et insipides (sûrement congelés), l'assiette du pêcheur un peu mieux, mais on sent que rien n'est frais, ni préparé sur place et qu'ils utilisent des produits de mauvaise qualité.	negative chipirons à l'encre | neutral assiette du pêcheur | negative produits                                                                                                       	 negative chipirons à l'encre | negative assiette du pêcheur
Les desserts étaient mangeables.	neutral desserts                                                                                                                            	 positive desserts                 
Le service ne venait pas vraiment relever le niveau.	negative service                                                                                                                            	 negative service                     
Il doit pas aller très bien!	negative Il doit pas aller très bien!                                                                                                                   	 negative Dentist                    
Nous avons pris l'assiette decouverte à 20 euros et nous n'avons pas été deçus Anchois, axoa, pommes de terre fromage salade ect.. copieux et surtout bon Produits frais, bien cuisinés La sangria était parfaite..	positive assiette decouverte | positive Produits | positive assiette decouverte | positive sangria                                                                                                           	 positive assiette decouverte | positive anchois | positive axoa | positive pommes de terre | positive salade
restaurant dans une charmante petite rue piétonne de Saint Jean de Luz.	positive rue piétonne                                                                                                                          	 positive restaurant                      
surprise avant même de passer la commande : une araignée était logée dans le menu!!! Aussitôt l'apéritif servi, la serveuse nous a apporté les soupes de poissons!	negative serveuse                                                                                                                           	 negative serveuse                 
erreur vite rectifiée par le patron.	positive patron                                                                                                                             	 negative patron                  
J'ai commandé un magret bleu avec des frites, celui ci est arrivé servi avec du gratin de pommes de terre.	negative magret                                                                                                                           	 negative magret bleu avec des frites | negative gratin de pommes de terre
il est reparti en cuisine pour être servi avec des frites et à son retour devant moi, il était froid!!! franchement pas le restaurant où je retournerai!	negative restaurant                                                                                                                            	 negative restaurant                  
En plus la serveuse n'est même pas agréable et souriante	negative serveuse                                                                                                                           	 negative serveuse 
Le cadre, dîner au bord de la piscine.	positive cadre                                                                                                                            	 positive cadre  
La cuisine qui mériterait largement une étoile au Michelin.	positive cuisine                                                                                                                             	 positive cuisine   
Ce restaurant sur le port à attirer notre attention par la sobriété de sa carte.	positive carte                                                                                                                             	 positive restaurant sur la port
L'apéro à été un peu accéléré par un serveur visiblement pressé de finir son service et qui est venu nous proposer de goûter le vin alors que nous commentions seulement à goûter les toast de tapenade.	negative serveur                                                                                                                           	 negative serveur          
( repris rapidement par le chef de salle)	neutral chef de salle                                                                                                                          	 negative chef de salle        
En entrée un assortiment de charcuterie corse et des beignets de fromages excellentes.	positive assortiment de charcuterie corse | positive beignets de fromages                                                                                                              	 positive charcuterie corse | positive beignets de fromages
Puis une dorade du jour avec petits légumes : joliment présenté et très savoureux.	positive dorade du jour | positive dorade du jour                                                                                                                    	 positive dorade du jour avec petits légumes   
Au final une bonne table à découvrir!	positive table                                                                                                                             	 positive table          
service mauvais	negative service                                                                                                                            	 negative service         
prix abusif pour la prestation	negative prix abusif pour la prestation                                                                                                                      	 negative prestation | negative prestation   
Vieux mouton en guise d'agneau	negative agneau                                                                                                                           	 negative mouton en guise d'agneau
assiette corse pire que sandwich SNCF	negative assiette corse                                                                                                                         	 negative assiette corse           
assiette de fromage au singulier.....	negative assiette de fromage                                                                                                                        	 negative assiette de fromage          
J'y suis allé plusieurs fois l'an passé c'était très correcte mais à priori quelque chose a changé en cuisine par rapport à l'an dernier car c'est devenu un vrai cauchemar.	negative cuisine                                                                                                                            	 positive cuisine | negative cuisine           
Pizza avec la pate caoutchouc et pas cuite, entrecôte hyper grasse j'ai dû en manger 1/4.	negative Pizza | negative entrecôte | negative pate                                                                                                                  	 negative Pizza | negative pate caoutchouc | negative entrecôte
Très bel endroit pour une pause déjeuner, à l'abri du soleil, avec un petit air rafraîchissant et vue sur le port.	positive vue | positive endroit | positive endroit                                                                                                                     	 positive endroit | positive air rafraîchissant
Cuisine simple mais bonne, Marco vous accueille très bien, vous donne des bonnes adresses si vous demandez.	positive Cuisine | neutral Cuisine                                                                                                                          	 positive Cuisine | positive Marco      
C'est un endroit très agréable.	positive endroit                                                                                                                            	 positive endroit        
On y a manger le soir, sa terrasse est sur une place très jolie avec son églises.	positive place | positive terrasse                                                                                                                          	 positive terrasse | positive églises     
Le repas était très bon l'entrée, le plat et le dessert.	positive repas                                                                                                                             	 positive repas | positive entrée | positive plat | positive dessert
Juste un blême le serveur ou le directeur (j'ai pas compris ) avec son cigare il se reconnaîtra (tant pis), et il parle trop!!!!	negative serveur | negative directeur                                                                                                                      	 negative serveur | negative directeur   
Honnêtement le cadre du restaurant est plutôt sympathique.	positive cadre                                                                                                                            	 positive cadre         
"Le service et l'accueil est ""jeune"" et professionnel."	positive service | positive accueil                                                                                                                         	 positive service | positive accueil      
La carte vous propose un large choix type brasserie.	positive carte                                                                                                                             	 positive carte brasserie          
Le Burger aux fromages est bien présenté, mais la tranche de fromage est égale au Macdonald... Aucune saveur et intérêt...	positive Burger aux fromages | negative tranche de fromage                                                                                                                  	 neutrale Burger aux fromages | negative tranche de fromage
La sauce roquefort trop crémeuse, pas de goût...	negative sauce roquefort                                                                                                                        	 negative sauce roquefort       
La mousse au chocolat est en réalité une ganache pleine d'eau...	negative mousse au chocolat                                                                                                                         	 negative mousse au chocolat        
Vraiment dommage vu le quartier et le cadre.	positive quartier | positive cadre                                                                                                                        	 negative quartier | negative cadre   
De l'accueil à l'assiette en passant par le rythme du service.	positive accueil | positive assiette | positive service                                                                                                                     	 positive accueil | positive assiette | positive service  
Le décor est magnifique et c'est mieux de réserver une table au second étage où se situe la verrière ouverte en été.	positive décor | positive verrière                                                                                                                        	 positive décor | positive verrière ouverte en été
La cuisine est à la hauteur de la réputation de ce restaurant.	positive cuisine | positive restaurant                                                                                                                          	 positive cuisine | positive restaurant       
Les entrées sont à 7 euros et copieuses.	positive entrées | positive entrées                                                                                                                      	 positive entrées | positive entrées 
Les plats sont bons mais ne vous attendez pas à de grandes surprises.	positive plats | neutral plats                                                                                                                          	 positive plats | negative plats    
"Ils maîtrisent les plats typiques ""bistrot""."	neutral plats | positive plats                                                                                                                          	" positive plats ""bistrot""    "
Les viandes sont excellentes notamment la bavette échalotes.	positive bavette échalotes | positive viandes                                                                                                                    	 positive viande | positive bavette échalotes
Leur petit pot au chocolat en dessert est une tuerie.	positive pot au chocolat                                                                                                                           	 positive petit pot au chocolat en dessert         
Mon compagnon est végétarien et ils n'ont actuellement que des gnocchis à la crème de crustacés à proposer en plat.	negative plat                                                                                                                            	 negative gnocchis à la crème de crustacés
Mais nous resterons des clients réguliers de cette adresse incontournable des amoureux des brasseries typiquement parisienne.	positive adresse                                                                                                                             	 positive brasseries typiquement parisienne         
Le lieu est très sympathique, bien décoré.	positive lieu | positive lieu                                                                                                                        	 positive lieu | positive décoré         
Les plats n'ont aucun goût, pas d'assaisonnement c'est tout à fait grossier pour une note bien salée.	negative plats | negative plats | negative plats                                                                                                                    	 negative plats | negative assaisonnement  
Pour bien connaitre la cuisine marocaine ce restaurant a tout d'un attrape touriste qui fait honte à la cuisine locale.	negative restaurant | negative cuisine                                                                                                                        	 negative restaurant         
Cette salle dansante est agréable malgré son étroitesse nous nous sommes amusés mais il y avait peu de monde alors je ne sais pas si le plaisir est toujours là les soirs d'affluence.	neutral salle dansante                                                                                                                          	 positive salle dansante | negative salle dansante
Le service est correct poli mais sans entrain.	neutral service                                                                                                                             	 neutral service          
Attente démesurée, le vin demandé n'est plus en cave, mais on ne nous en propose pas d'autre!	negative Attente | negative vin                                                                                                                       	 negative vin                
Par contre, sur la note, un vin très cher est compté!!	negative Par contre, sur la note, un vin très cher est compté!!                                                                                                           	 negative vin | negative vin            
3 plats arrivent enfin, puis une viande demandée bleue apportée bien cuite.	negative viande                                                                                                                           	 negative plats | negative viande demandée bleue apportée bien cuite
Longtemps après, les premiers ayant deja fini, la deuxième viande bleue, froide.	negative viande                                                                                                                           	 negative viande bleue            
Personnel peu aimable, peu disponible, un repas d'anniversaire qui a tourné aigre.	negative Personnel                                                                                                                          	 negative Personnel | negative repas anniversaire
En famille, après une longue balade, la météo sympathique a fait que la terasse nous a attiré.	positive terasse                                                                                                                            	 positive terasse        
Le service et la cuisine sont correctes.	neutral service | neutral cuisine                                                                                                                          	 positive service | positive cuisine      
Les enfants ont adoré le mi-cuit au chocolat maison.	positive mi-cuit au chocolat                                                                                                                        	 positive mi-cuit au chocolat maison   
Si vous passez par là, vous pouvez vous arreter pour le cadre, les oiseaux et canards environnants, mais sans attendre quelque chose d'exceptionnel de la cuisine.	positive cadre | neutral cuisine                                                                                                                         	 positive cadre | positive oiseaux | positive canards   
Entrée plat dessert en plein Montmartre avec une qualité correcte, je trouve ça pas mal.	neutral Entrée plat dessert | positive Montmartre                                                                                                                     	 neutral Entrée plat dessert | positive Montmartre     
Ravioles et tartiflette correctes, crêpe suzette passable.	neutral Ravioles | neutral tartiflette | negative crêpe suzette                                                                                                               	 positive Ravioles | positive tartiflette | positive crêpe suzette
Effectivement les serveurs sont chez eux et ne font pas cas des clients quand ils discutent.	negative serveurs                                                                                                                           	 positive serveurs            
Après ça mais une certaine ambiance dans la salle.	neutral ambiance                                                                                                                            	 negative ambiance      
Repas ordinaire mais qui permet de manger à moindre coût et au chaud.	neutral Repas | positive Repas                                                                                                                        	 neutrale Repas ordinaire | positive Repas
Le personnel n'est pas très sympa.	negative personnel                                                                                                                            	 negative personnel       
On est un peu à l'étroit mais c'et le principe de ce genre de petite brasserie, déco à revoir car vieillissante mais familiale et conviviale.	positive déco | neutral brasserie | negative déco                                                                                                                     	 negative brasserie | positive déco   
Dîner décevant de tout point de vue : ambiance assez triste (seulement 4 tables occupées ce dimanche soir), service un peu froid (une seule personne en salle, souvent absente, il fallait attendre son retour à chaque fois que nous voulions demander quelque chose), plats décevants : le riz arborio aux truffes apparaissant dans le menu à la carte disponible sur le site web du restaurant était devenu un simple risotto aux champignons (	negative ris de veau | negative riz arborio aux truffes | negative riz arborio aux truffes | negative ris de veau | negative ambiance | negative service | negative plats                                                                             	 negative riz arborio aux truffes | negative service | negative plats
Vins au verre décevants.	negative Vins au verre                                                                                                                        	 negative Vins au verre décevants        
Le soufflé que j'avais repéré sur la carte du site web n’était plus proposé.	negative carte                                                                                                                            	 negative soufflé              
Une adresse à conseiller si vous aimez la cuisine traditionnelle, avec juste ce qu'il faut de goût.	positive cuisine traditionnelle                                                                                                                           	 positive cuisine traditionnelle | positive cuisine traditionnelle          
Les escargots sont délicieux, l'os à moelle savoureux, et le bourguignon de nos voisins embaumait...	positive escargots | positive os à moelle | positive bourguignon                                                                                                             	 positive escargots | positive os à moelle | positive bourguignon
Petite salle mais beaucoup moins bruyante que l'on pourrait le croire, les vieilles pierres absorbent le bruit.	positive salle                                                                                                                            	 negative salle | positive vieilles pierres       
Service souriant, ni trop lent ni trop rapide.	positive Service                                                                                                                             	 positive Service                
Bon, un peu cher mais ce n'est pas un restaurant du quotidien.	neutral restaurant | neutral restaurant                                                                                                                          	 neutral restaurant | negative restaurant            
Menus imposés.	negative Menus                                                                                                                           	 negative Menus                 
Apéritifs médiocres.	negative Apéritifs                                                                                                                          	 negative apéritifs               
Assiettes de tapas ridicules.	negative Assiettes de tapas                                                                                                                         	 negative Assiettes de tapas               
Plat arrivé froid, viande mal cuite, pomme de terre froides, courgettes crues, salade chaude, plat trop salé dans son ensemble, bon point pour la sauce au vin.	negative Plat | negative viande | negative pomme de terre | negative courgettes | negative salade | positive sauce au vin | negative plat                                                                                           	 negative Plat | negative viande | negative courgettes | negative sauce au vin
Vin âcre.	negative Vin                                                                                                                            	 negative Vin âcre         
Tarte aux pommes au calva sans calva digne d'une cantine d'école.	negative Tarte aux pommes au calva | negative Tarte aux pommes au calva                                                                                                          	 negative Tarte aux pommes au calva sans calva  
Arnaque du siècle, les assiettes sont peu fournies, les plats médiocres et le rapport qualité/ prix est totalement ahurissant.	negative assiettes | negative plats                                                                                                                       	 negative assiettes | negative plats | negative rapport qualité/ prix
Des frites surgelées...	negative frites                                                                                                                           	 negative frites surgelées         
Des boissons hors de prix.. mais c'est la même chose sur toute la place... des sièges peu confortables mais une couverture proposée... une naturelle bonne humeur...	negative boissons                                                                                                                           	 negative boissons | positive sièges | positive couverture 
une nourriture correcte...	neutral nourriture                                                                                                                           	 positive nourriture          
Ce petit restaurant discret vaut le détour, d'abord - et il faut le souligner - pour le chaleureux accueil que le patron réserve à ses clients (merci pour le kir ;), mais aussi pour la qualité des plats servis.	positive plats | positive restaurant | positive accueil                                                                                                                      	 positive accueil | positive plats servis       
Les entrées sont simples mais très bonnes, et le menu offre deux séries de plats qui permettent de s'adapter à tous les budgets.	positive entrées | positive menu | positive plats | neutral entrées                                                                                                                	 positives entrées | positive menu | positive séries de plats
L'assaisonnement était réalisé directement en cuisine et particulièrement délicieux.	positive assaisonnement                                                                                                                           	 positive assaisonnement         
La gamme de dessert est humble, mais chacun d'eux est relevé par une petite touche créative du patron, qui en relève la saveur.	positive dessert | neutral dessert                                                                                                                          	 neutral gamme de desserts | positive touche créative du patron
"Sans hésiter un endroit où il fait bon manger avec un ami ou un membre de sa famille, et qui contraste fortement avec les brasseries ""industrielles"" que l'on trouve parfois à Paris."	positive endroit | positive endroit                                                                                                                        	" positive brasseries ""industrielles""       "
Une cuisine fine, créative et absolument délicieuse, un cadre chaleureux et un service très agréable.	positive cuisine | positive cadre | positive service | positive cuisine                                                                                                                   	 positive cuisine | positive cadre | positive service     
En entrée, nous avons pris le haddock façon flammekueche (délicieux) et une sorte de canard confis en gelée avec noix et poires (très bon).	positive haddock façon flammekueche | positive canard confis                                                                                                                	 positive haddock façon flammekueche | positive canard confis en gelée avec noix et poires
En plat, j'ai complètement craqué sur le cabillaud risotto émulsion de chorizo (très surprenant).	positive cabillaud risotto émulsion de chorizo                                                                                                                   	 positive cabillaud risotto émulsion de chorizo             
Enfin la masterpiece : le riz au lait vanille sauce caramel beurre salé (divin).	positive riz au lait vanille sauce caramel beurre salé                                                                                                                 	 positive riz au lait vanille sauce caramel beurre salé (divin)       
La tarte sablée aux agrumes était également parfaite pour rafraîchir un diner particulièrement copieux.	positive tarte sablée aux agrumes | positive diner                                                                                                                  	 positive tarte sablée aux agrumes                
Les serveurs étaient également adorables.	positive serveurs                                                                                                                            	 positive serveurs          
Un formidable moment, nous y retournerons c'est sûr, et recommandons chaudement ce restaurant!	positive restaurant                                                                                                                             	 positive restaurant           
le service etait proche du zero absolue et le serveur pas tres aimable mais... si la bouffe etait correcte, je ne serai pas venu ici mettre un avis..	negative service | negative serveur | negative bouffe                                                                                                                  	 negative service | negative serveur | negative bouffe
oh mon dieu, frites pas bien cuite, froide et qui sortent a peine du congelateur...la bavette aie aie aie, elle a baigne dans l'huile et aucun gout...	negative frites | negative bavette                                                                                                                      	 negative frites | negative bavette    
je pense me rattraper sur le dessert avec la mousse au chocolat lol, et je goute une mousse execrable vraiment!	negative mousse au chocolat                                                                                                                         	 negative mousse au chocolat                       
pas de chance, jetais malade l'apres midi, le repas y est ss doute pour quelque chose!!	negative repas                                                                                                                            	 negative repas                          
Le meilleur cadre de la rue avec ses poutres et ses charpentes authentiques des tables spacieuses des prix et un rapport qualité prix rare avec des produits frais et fais maison.	positive cadre | positive produits                                                                                                                        	 positive cadre | positive poutres | positive charpentes | positive tables spacieuses | positive produits frais | positive tables
Différentes formules à 12,5€, 15,80€ et 18,90€ qui regroupent entrée + plat + dessert!!! Autant dire que c'est très rare à St.	positive formules | positive formules                                                                                                                        	 negative entrée | negative plat | negative dessert                 
Les serveurs sont très souriants et patients.	positive serveurs                                                                                                                            	 positive serveurs     
Je suis allé à plusieurs reprises lors de mes escapades parisiennes, dîner dans cet établissement bien situé.	positive établissement                                                                                                                            	 positive établissement     
L'accueil est très sympathique ; le personnel est dynamique, serviable.	positive accueil | positive personnel                                                                                                                         	 positive accueil | positive personnel  
Manger le soir en terrasse est un pur régal.	positive terrasse                                                                                                                             	 positive Manger le soir en terrasse
Le contenu des assiettes est tout aussi réussi : copieux et très bon de l'entrée aux desserts.	positive assiettes | positive assiettes                                                                                                                        	 positive contenu des assiettes      
Je continuerai aller passer de bons moments dans cet établissement lors de mes prochains voyages dans un cadre charmant	positive établissement | positive cadre                                                                                                                        	 positive établissement | positive cadre     
Nous avons été au départ attirés par une terrasse ensoleillée, au calme et par sa carte aux prix raisonnables.	positive terrasse | positive carte                                                                                                                          	 positive terrasse | positive carte       
Les plats sont bons voire très bons, extrêmement variés avec un menu du jour poisson et viande modifié quotidiennement (Soupe de pois capuchino à ne pas manquer) Il s'agit d'une cuisine familiale faite maison la plupart du temps.	positive plats | positive menu du jour | positive Soupe de pois capuchino | positive cuisine | positive plats | positive cuisine                                                                                                     	 positive plats | positive menu du jour poisson et viande
L'équipe est sympa,serviable.	positive équipe                                                                                                                            	 positive équipe                 
Un restaurant d'une médiocrité sans nom!	negative restaurant                                                                                                                            	 negative restaurant                 
Nous avons attendu 15 mn pour qu'on nous prépare la table et 40mn après avoir commandé pour être servies un boeuf bourguignon dont la qualité et le goût laissent à désirer!	negative boeuf bourguignon                                                                                                                       	 negative boeuf bourguignon | negative boeuf bourguignon   
Des pommes de terres quasiment crues avec des carottes crues et une sauce sans goût et non assaisonnée!	negative pommes de terres | negative carottes | negative sauce                                                                                                             	 negative pommes de terres | negative carottes crues | negative sauce
Aucune communication de la part du personnel qui a servi d'autres clients arrivés après avant nous (entrée et plat) compris!	negative personnel                                                                                                                            	 negative personnel              
J'ai vraiment failli partir au bout d'une 40mn d'attente lorsque j'ai vu l'assiette arriver car j'ai clairement trouvé le comportement de la patronne exécrable et dédaigneux.	negative patronne                                                                                                                           	 negative patronne             
La vue de l'extérieur sur la grande étagère de bouteilles de vins nous a attirée.	positive grande étagère de bouteilles de vins                                                                                                                      	 positive vue de l'extérieur sur la grande étagère de bouteilles de vins
Nous sommes donc rentrés dans ce resto bar à vins à la déco hyper originale!	positive déco                                                                                                                             	 positive déco | positive resto bar à vins        
Les serveurs sont adorables, le vin et les conseils pour le choisir sont au top!	positive serveurs | positive vin                                                                                                                         	 positive serveurs | positive vin | positive conseils
Nous avons moins été séduits par les plats que nous avons trouvé un peu chers vs la qualite proposée bien que les produits soient frais et ça c'est important.	neutral plats | positive produits | negative plats                                                                                                                     	 negative plats | positive produits   
Dans une rue calme, l'accueil y est sympathique et chaleureux, la salle agréable et confortable.	positive salle | positive accueil | positive rue                                                                                                                     	 positive accueil | positive salle   
En famille ou entre amis, la tonalité de la musique à hauteur convenable, permet de tenir une conversation sans hurler, tout en dégustant d'excellents plats, joliment présentés et très savoureux, servis avec le sourire et accompagnés de très bons vins.	positive musique | positive plats | positive plats | positive vins                                                                                                                   	 positives plats | positives plats | positive vins
Je suis bien conscient que cet avis ne changera rien, le bar étant placé de manière à toujours pouvoir attirer des touristes mais bon, un lieu aussi scandaleux merite d'être dénoncé.	neutral bar | negative lieu                                                                                                                        	 negative bar | negative lieu
Le serveur dont nous avons hérité est un vieil acariâtre dont l'impolitesse traduit le dégoût qu'il a pour son métier et le peu d'estime qu il se porte sans doute à lui-même.	negative serveur                                                                                                                           	 negative serveur    
Ce service désagréable au possible est couronné d'une carte incompréhensible, aux prix exhorbitants.	negative service | negative carte | negative carte                                                                                                                    	 negative service | negative carte 
Déjà le restaurant n'est pas très bien placé je trouve.	negative restaurant                                                                                                                            	 negative restaurant     
Accueil pas trop mauvais, mais j'aurais préféré pouvoir discuter avec mon conjoint sans être écouté par une des serveuses..	neutral Accueil | negative serveuses                                                                                                                        	 neutral Accueil | negative serveuses
Au niveau du repas, ce fut assez rapide pour être servi.	positive Au niveau du repas, ce fut assez rapide pour être servi.                                                                                                             	 positive repas     
Le repas était assez bon, mais tout est sûrement congeléx et c'est dommage d'avoir eu mon dessert quand mon homme avait fini!	neutral repas | negative repas                                                                                                                         	 positive repas | negative dessert 
Nous avons découvert ce restaurant avec Groupon, je ne le conseille pas sans cette offre.	negative restaurant                                                                                                                            	 positive restaurant     
la terrasse est grande et en grande partie ensoleillée, le service est efficace et rapide, formule changeant tous les jours, et il y des plats avec supplément qui moi me mettent souvent l'eau à la bouche.	positive terrasse | positive plats | positive service | positive formule                                                                                                                    	 positive terrasse | positive service | negative plats avec supplément
ah : quand il fait un peu frisquet, la terrasse est chauffée et ils mettent des plaids à dispo sur les chaises, ça aide :)	positive terrasse                                                                                                                             	 positive terrasse | positive plaids à dispo sur les chaises
Les pizzas sont correctes et les plats du jour sont très chers.	neutral pizzas | negative plats du jour                                                                                                                      	 neutral pizzas | negative plats du jour    
Pas de viandes sur la carte.	neutral carte                                                                                                                             	 negative viandes sur la carte     
Tiramisu très bon et abondant.	positive Tiramisu | positive Tiramisu                                                                                                                      	 positive Tiramisu | positive Tiramisu    
Les excellentes critiques de ce restaurant se sont confirmées à table.	positive restaurant                                                                                                                             	 positive restaurant           
Le menu-carte offre un choix pour tous les goûts et permet de découvrir des plats de saison bien présentés.	positive menu-carte | positive plats de saison                                                                                                                     	 positive menu-carte | positive plats de saison   
La carte est a priori renouvelée chaque jour de 3 entrées, 3 plats et 3 desserts.	positive carte                                                                                                                             	 positive carte d'entrées | positive plats | positive desserts
Mais les incontournables restent manifestement la dorade en tartare, les crevettes cajun, les gnocchi d'agria à la truffe blanche, le dos de cabillaud à la plancha (parfaitement cuit et servi sur un lit de salsifis).	positive dorade en tartare | positive crevettes cajun | positive gnocchi d'agria à la truffe blanche | positive dos de cabillaud                                                                                          	 positive dorade en tartare | positive crevettes cajun | positive gnocchi d'agria à la truffe blanche | positive dos de cabillaud à la plancha
La carte des vins est également courte et fait la part belle aux Côtes du Rhône et Languedoc Roussillon en mettant en avant des cuvées abordables dont quelques unes issues de producteurs reconnus.	neutral carte des vins | positive cuvées | positive cuvées                                                                                                                   	 positive carte des vins | positive cuvées issues de producteurs reconnus                            
Service attentif et sympathique.	positive Service                                                                                                                             	 positive Service                                        
Le sommelier n'hésite pas à changer une bouteille présentant un défaut.	positive sommelier                                                                                                                            	 negative sommelier                                      
Ambiance bistrot chic.	neutral Ambiance                                                                                                                            	 positive Ambiance bistrot chic
Un peu bruyant mais comme le restaurant parait rempli tous les soirs...	negative restaurant | positive restaurant                                                                                                                         	 negative restaurant | positive restaurant 
Une bonne adresse à deux pas de l'Etoile.	positive adresse | neutral Etoile                                                                                                                         	 positive adresse     
Encore un resto qui perd petit à petit de la qualité.	negative resto                                                                                                                            	 negative resto    
La deco est géniale, je suis plutôt fan, même si la préférence va à la Deco de type recup ou industriel, cette deco type romantique me plait plutôt.	positive deco                                                                                                                            	 positive deco | positive déco type romantique
A l'intérieur on est tranquille et si on aime voir du monde passer on se met en terrasse, très agréable en été d ailleurs ou je passe ps mal de temps avec les copains à regarder les gens passer.	positive terrasse | positive intérieur                                                                                                                         	 positive intérieur | positive terrasse   
Encore un fois le problème comme dans pas mal de resto finalement le problème réside dans la nourriture qui n'est pas au niveau, ni de l'adresse, ni de l'effort fait à la déco.	negative nourriture | positive déco                                                                                                                       	 negative nourriture | negative déco
Il y a quelques années, le burger en forme de cœur était un must have, il est aujourd'hui devenu commun, je ne le finis meme plus.	negative burger                                                                                                                            	 positive burger en forme de cœur 
J'ai adoré le décors...	positive décors                                                                                                                            	 positive décors            
J'ai apprécié l'histoire des lieux.	positive histoire des lieux                                                                                                                         	 positive histoire des lieux         
Nus avons eu huîtres, crevettes roses et homard en entrée, les produits étaient de qualité.	positive produits                                                                                                                            	 positive huîtres | positive crevettes roses | positive homard
Les crevettes étaient fermes et excellente.	positive crevettes                                                                                                                           	 positive crevettes           
le homard un peu petit, du canadien sans doute.	negative homard                                                                                                                           	 negative homard    
La soupe tout d'abord très bonne, généreux en croûtons...	positive soupe | positive soupe                                                                                                                        	 positive soupe | positive croûtons
La suite, les poissons très fins, un des poissons était rempli d'arrête, c'est dommage mais bon...	positive poissons | negative poissons                                                                                                                       	 negative suite | negative poissons
Cela n'enlève rien à la qualité de la bouillabaisse...	positive bouillabaisse                                                                                                                          	 positive bouillabaisse   
Belle réussite sur le soufflé, attention taille impressionnante!! Fond bien dans la bouche, pas lourd du tout!	positive soufflé | positive soufflé                                                                                                                      	 positive soufflé | positive soufflé
C'était un très bon déjeuner.	positive déjeuner                                                                                                                           	 positive déjeuner     
Un restaurant extrêmement bien situé tout en haut des Champs Elysée!	positive restaurant                                                                                                                             	 positive restaurant       
Niveau décoration cela reste très inventif et change de la décoration ordinaire.	positive décoration                                                                                                                            	 positive décoration      
La cuisine est correcte pour les prix pratiqués.	neutral cuisine | positive cuisine                                                                                                                          	 neutral cuisine              
Le personnel est très occupé par les différentes tables donc ne vous attendez pas à une attention particulière envers vous!	negative personnel                                                                                                                            	 neutral personnel              
Restaurant à essayer (au moins une fois) pour vous en faire une idée.	positive Restaurant                                                                                                                             	 positive Restaurant              
Très bel endroit avec vue sur la Tour Eiffel c est certain mais et il y a vraiment un mais au delà des prix prohibitifs pour un dîner très moyen en qualité et très prétention en présentation...	positive endroit | positive vue | negative dîner | negative dîner | negative dîner                                                                                                          	 positive endroit | positive vue sur la Tour Eiffel | negative dîner
Le service est déplorable, il faut les supplier de prendre la commande, ils oublient d apporter la carafe d eau, ils ignorent nos mains levées et prennent un temps fou pour l addition	negative service                                                                                                                            	 negative service | negative carafe d eau
Cela faisait 5 ans que nous n étions pas revenu dans ce restaurant qui offre une terrasse superbe dans un quartier sympa de Paris...	positive terrasse | positive quartier                                                                                                                         	 positive terrasse | positive restaurant      
Mais mon dieu quel désastre au niveau du service et de la cuisine.	negative service | negative cuisine                                                                                                                        	 negative service | negative cuisine    
A notre arrivée 3 serveurs et serveuses nous sont passés devant avant que l on nous adresse simplement la parole.	negative serveurs | negative serveuses                                                                                                                      	 negative serveurs | negative serveuses  
L arrivée de la responsable fut caricaturale avec son plan de table chiffonnée essayant de nous placer à l intérieur malgré notre demande express de la terrasse.	negative responsable                                                                                                                           	 negative responsable     
Assis sur des chaises de jardin peu confortable nous attendons l apéro qui arrive très rapidement le seul hic c est la différence entre nos deux verres pour le même alcool 1/4 de quantité différente.	negative verres                                                                                                                           	 negative apéro | negative verres
Je vous passe le repas dont les produits sont quelconque.	negative produits                                                                                                                           	 negative produits     
Même les desserts de Pierre herme que j inviterais à ne plus autoriser la distribution dans cet établissement ont été servi.	negative desserts                                                                                                                           	 negative desserts de Pierre herme 
Bref je ne sais pas où sont passés les anciens propriétaires mais il faut que quelqu un reprenne cet établissement en main.	negative établissement                                                                                                                           	 negative établissement | negative propriétaires
Ah oui j oubliais ne regarder pas la carte affichée en vitrine vous y verrez au moins 2 mouches mortes écrasées je n ose pas mettre un pied dans la cuisine.	negative carte                                                                                                                            	 negative carte affichée en vitrine 
Une table qui tient la route dans un quartier où les tables changent très vite?	positive table                                                                                                                             	 positive table        
Très beau menu à 35 euros le midi qui change tout le temps.	positive menu                                                                                                                             	 positive menu | positive menu     
A la carte,plus cher, la sole meunière est un véritable délice (49 euros tout de même) et chacun sait à quel point c'est difficile de la réussir.	positive sole meunière | neutral carte | negative sole meunière                                                                                                                  	 negative sole meunière | positive sole meunière
La côte de veau aussi.	positive côte de veau                                                                                                                         	 positive côte de veau    
Vin au verre (heureusement!).	positive Vin au verre                                                                                                                          	 negative Vin au verre    
Café gourmand exquis.	positive Café gourmand                                                                                                                           	 positive Café gourmand      
En tout cas régulier dans un beau cadre à deux pas des Invalides.	positive cadre                                                                                                                            	 positive cadre | positive Invalides   
Quel plaisir dés l'accueil, ce grand sourire, cette bise, le tout très naturel, on n'est plus habitués à ce coté amical, surtout à Paris!	positive accueil                                                                                                                            	 positive accueil | positive bise    
Et le cadre!!! Et la cuisine!!! On vient aussi et surtout pour ça et notre dernier déjeuner était, comme toujours, extra : Turbot poché à la rhubarbe, sauce crémée avec sa purée de panais, île flottante et tarte aux pralines...le tout arrosé d'un excellent Beaujolais...que du bonheur et c'est ainsi que tous les clients deviennent des habitués, ou plutôt des amis	positive cadre | positive cuisine | positive déjeuner | positive Turbot poché à la rhubarbe | positive sauce crémée | positive île flottante | positive tarte aux pralines | positive Beaujolais                                                                               	 positive cadre | positive cuisine | positive Beaujolais
Terrasse ensoleillée le dimanche, décor plutôt sympa, ça s' annonçait plutôt bien....	positive Terrasse | positive décor                                                                                                                         	 positive Terrasse ensoleillée | positive décor  
On commande deux piscines de champagne qui nous sont servies au bout de 20 min... et sans glaçons!!!	negative piscines de champagne                                                                                                                         	 negative piscines de champagne         
Quand on demande à un serveur aigri comme un cornichon macéré dans du vinaigre depuis 54 ans si notre commande a bien été prise il nous agresse littéralement en nous disant que le champagne est en train d'être cherché (visiblement directement à Reims)	negative serveur                                                                                                                           	 negative serveur           
Bref, les serveurs ne prennent même pas la peine de parler en anglais aux pauvres touristes échoués ici, la patronne siliconnée, botoxée, jusqu'à en avoir le visage figé (ça doit être la raison de sa cruelle absence de sourire) se pavane sur la terrasse mais ne fait pas avancer les commandes plus vite...	negative serveurs | negative patronne                                                                                                                      	 negative serveurs | negative patronne      
Service superbe et très accueillant, malheureusement ils ne savent pas décrire les plats, les noms originaux des plats sont incompréhensible.	positive Service | negative plats | negative Service                                                                                                                     	 positive Service | negative plats | negative noms originaux des plats
Une fois servis j'ai cru que j'allais me sentir mal, ma bavette était noyée sous une quantité absurde de sauce au bleu insipide, quant à la salade de mon amie elle était pleine d'huile, de graisse et de gras.	negative bavette | negative sauce au bleu | negative salade                                                                                                              	 negative bavette | negative salade de mon amie
C'est une très très belle adresse... la cuisine est remarquable car les cuissons sont parfaites, les produits ultra frais et plutôt de saison, tout est fait maison.	positive adresse | positive cuisine | positive produits                                                                                                                      	 positive cuisine | positive cuissons | positive produits de saison 
L'assiette est parfaite de l'entrée jusqu'au dessert, ce qui n'est pas si fréquent.	positive assiette                                                                                                                            	 positive assiette          
La carte des vins est focus mais très très bien, en blanc comme en rouge.	positive carte des vins | neutral carte des vins                                                                                                                      	 positive carte des vins         
Ce ne sont pas des premiers prix mais on peut dire que le rapport qualité-prix est excellent.	positive rapport qualité-prix est excellent.                                                                                                                       	 positive rapport qualité-prix      
L'accueil et le service sont à la fois pros mais détendus, il y a ce qu'il faut pour se sentir bien mais aussi être très très bien reçus et y revenir!	positive accueil | positive service                                                                                                                         	 positive accueil | positive service     
C'est pour conclure une très belle adresse, une rare alliance de tradition et de modernité, de belle cuisine mais qui reste lisible, agréable, sophistiquée sans trop.	positive adresse | positive cuisine | positive cuisine                                                                                                                       	 positive cuisine | positive alliance de tradition et modernité
Ce restaurant est idéalement placé pour les repas d'affaires.	positive restaurant                                                                                                                             	 positive restaurant         
Les plats à la carte sont hors de prix (une vingtaine d'euros pour 4 vapeurs... certes bonnes mais cela fait beaucoup pour une vapeur) et ne sont pas d'une qualité exceptionnelle.	negative plats à la carte | positive vapeurs | negative vapeurs | neutral plats à la carte                                                                                                      	 negative plats | negative vapeurs         
Si l'on veut deux accompagnements, cela est même compté en supplément!!	negative accompagnements                                                                                                                           	 negative accompagnements              
Quant au service, il est vraiment à revoir.	negative service                                                                                                                            	 positive service                
Menu un peu compliqué entre Bo Boun's, salades et le reste.	negative Menu                                                                                                                            	 negative Menu entre Bo Boun's | negative salades | negative rest
Il vaut mieux avoir bon appétit car les plats sont copieux et bons.	positive plats | positive plats                                                                                                                          	 positive plats | positive plats               
Dommage que la salle soit aussi peu confortable, on est un peu les uns sur les autres et si vous êtes corpulents, préférez la terrasse.	negative salle                                                                                                                           	 negative salle | negative salle           
Le personnel est souvent débordé mais c'est la clé de la réussite et de la renommée.	neutral personnel                                                                                                                             	 positive personnel                  
Menu super, accords de saveurs inédits et surprenants, cadre très agréable....dommage que l'impression générale soit desservie par un service hautain et désagréable!	positive cadre | positive Menu | positive Menu | negative service                                                                                                                  	 positive Menu | positive accords de saveurs inédits | positive cadre | negative service
A trop vouloir fuir les codes du resto gastronomique (et notamment l'excès de zèle qui peut parfois en caractériser le service), le Chateaubriand va à mon sens trop loin!	negative service                                                                                                                            	 negative Chateaubriand | negative resto gastronomique    
Certes c'est un honneur de pouvoir goûter à la cuisine inventive d'un chef comme Inaki Aizpitarte... mais quelque soit la renommée de l'établissement et son succès, je pense que les clients ont le droit d'attendre à être servis par des personnes au minimum aimables (ne serait-ce que parce qu'ils paient)!	positive cuisine                                                                                                                             	 positive cuisine d'un chef comme Inaki Aizpitarte | negative service
"Et la personne qui m'accompagnait, auvergnate, s'est elle permise une remarque avec un grand sourire sur l'épaisseur de la tranche de St-Nectaire qui lui avait été servie (moins de 2mm) pour s'entendre répondre un ""Ah bon..."" sec et froid."	negative tranche de St-Nectaire                                                                                                                     	 negative personne             
Bref, dommage que le succès de l'établissement semble être monté à la tête des serveurs qui ont terni, voire gâché ce qui aurait pu être un très bon moment...	negative serveurs                                                                                                                           	 negative serveurs            
ps: sommelier top en revanche!	positive sommelier                                                                                                                            	 positive sommelier 
Carte compliquée à déchiffrer.	negative Carte                                                                                                                            	 negative Carte 
Plats très moyens.	negative Plats                                                                                                                           	 negative Plats
Aucune souplesse dans la carte.	negative carte                                                                                                                            	 negative carte 
A titre d'exemple, si vous demandez des frites à la place de la garniture prévue, vous aurez la garniture prévue et un supplément frites (surgelées) à 5 euros.	negative supplément frites | negative supplément frites                                                                                                                  	 negative garniture | negative frites (surgelées) à 5 euros
Bref, cadre sympathique, personnel agréable, carte de vins conséquente mais plats proposés et carte à revoir en profondeur.	positive cadre | positive personnel | positive carte de vins | negative plats | negative carte                                                                                                            	 positive cadre | positive personnel | positive carte de vins | negative plats    
L'ambiance est bruyante mais relativement agréable.	positive ambiance                                                                                                                            	 positive ambience                
Après un quart d'heure d'attente, un serveur arrive.	negative attente                                                                                                                           	 negative serveur               
La nourriture est honnête, j'ai choisi une tartine de chèvre chaud, mon mari le menu à 13 euros.	neutral nourriture                                                                                                                           	 positive nourriture | positive tartine de chèvre chaud | positive menu à 13 euros
Bref une adresse convenable, si on accepte d'être traité comme un simple régleur d'addition...	neutral adresse                                                                                                                             	 negative adresse                 
Nous arrivons dans une salle quasi-vide un vendredi soir, malgré la recommandation d'une amie de ce restaurant comme étant une bonne adresse gastro à prix sympa...	negative salle                                                                                                                           	 negative restaurant | positive adresse gastro             
Tout comme les horribles rideaux qui pendouillent au dessus de nos têtes.	negative rideaux                                                                                                                           	 negative rideaux                
Côté cuisine, un manque complet de surprise, de découverte ou d'audace...	negative cuisine                                                                                                                            	 negative cuisine                    
Les portions sont ridicules, trois bouchées d'onglet de veau (veaux de 25 ans sans doute, tellement la viande est rouge) et une fine lamelle de gratin dauphinois, le tout baignant dans une sauce insipide qui semblait en réalité être... de l'eau.	negative portions | negative onglet de veau | negative onglet de veau | negative gratin dauphinois | negative sauce                                                                                          	 negative portions | negative onglet de veau | negative gratin dauphinois
Le thon est tellement cru qu'il faut mieux aller chez le japonais, mais ma compagne aime ça, les thons...	negative thon                                                                                                                           	 negative thon | positive thons               
"On aimerait arrêter les frais, mais il y avait le dessert : la poire belle Hélène ""revisitée"", où comment une glace se transforme en crème dans une marre de chocolat où surnage des morceaux de fruits."	negative glace                                                                                                                           	 negative dessert | negative poire belle Hélène           
Oui ça doit être cela, ce soir, j'ai perdu le goût, le goût de claquer 100€ dans un resto sans saveur ni ambiance.	negative resto | negative ambiance                                                                                                                       	 negative resto | negative resto
Mais étant donné que nous étions trop nous nombreux (13 personnes), nous avons été installé à l'étage (en nous faisant bien précisé que le rez-de-chaussée était destiné aux habitués et amateur de football et que si nous souhaitions consommer il fallait redescendre pour commander) dans un espace Iounge à peine éclairé pour pouvoir lire le menu (nous avons dû utiliser les lampes de nos smartphone).	negative espace Iounge                                                                                                                        	 negative espace Iounge
Après avoir fait comprendre au personnel qu'il était possible d'aligner une table à côté d'une autre, nous sommes redescendus.	negative personnel                                                                                                                            	 negative personnel    
Dans le partie concernant les burgers il était écrit qu'il était possible de commander le burger sans le pain (intérêt?).	neutral burgers                                                                                                                            	 negative burger    
"En demandant a une serveuse si le fait de prendre cette option permettait un rabais sur le tarif (déjà suffisamment cher pour la qualité), le responsable est arrivé en disant que le prix ne changeait pas (après cela vient une explication sur la marge que réalisait alors le restaurant), et a rétorqué plus tard ""nous sommes un restaurant donc notre but est de faire de la marge"" (un expert en relation client celui-là)."	negative responsable                                                                                                                           	 negative responsable | negative restaurant           
En résumé (parce que ça fait long a dire), nous avons passé une soirée un peu ternie par l'image du restaurant (dont l'état laisse à désirer), un service à table digne digne d'une cantine d'adolescent, et aucun petit mot d'excuse ou remise quelconque (quand il faut faire de la marge par n'importe quel moyen...) pour repartir avec le sourire (c'était pas gagné).	negative service | negative restaurant                                                                                                                        	 negative restaurant | negative service à table | negative cantine d'adolescent
Pour avoir été testé par des membres de la soirée au préalable, nous sommes tombés d'accord sur le fait que c'était la première fois pour certains et la dernière fois pour tout le monde que nous venions dans ce restaurant!	negative restaurant                                                                                                                            	 positive restaurant                 
TOUTES LES VIANDES SONT SANS GOUT ET SECHES!!!	negative VIANDES                                                                                                                           	 positive VIANDES                
Les frites sont certes maisons mais FAITES DES HEURES A L AVANCE ET MOLLASSONNES.	negative frites                                                                                                                           	 positive frites | negative frites   
Puree moins bonne qu a la cantine.	negative Puree                                                                                                                           	 negative Puree       
- une entrée saumon fumé sur céleri excellent	positive saumon fumé                                                                                                                          	 positive entrée saumon fumé sur céleri 
- sauté de veau au tagliatelle très bon	positive sauté de veau                                                                                                                        	 positive sauté de veau au tagliatelle
Vin un peu cher	negative Vin                                                                                                                            	 negative Vin | negative Vin
- la salle est surchauffée ce qui est vraiment désagréable	negative salle                                                                                                                           	 negative salle   
- l'eau en caraffe n'est pas fraiche (à relier avec le point précédent???)	negative eau en caraffe                                                                                                                        	 negative eau en caraffe
Très compétitif pour le quartier et la qualité de ce que l'on a dans notre assiette.	positive assiette                                                                                                                            	 positive quartier | positive assiette
Le service est sympathique mais très expéditif, on à pas le temps de finir un plat que l'on nous demande si on à terminer.	positive service | negative service                                                                                                                         	 positive service | negative service            
Si vous êtes pressés c'est l'endroit idéal!	positive endroit                                                                                                                            	 positive endroit               
Mais ce qui m'a gêné est la chose suivante : seulement deux minutes après avoir passé commande, nous étions déjà servit, les escalopes panées seraient elles toute faites à l'avance puis réchauffées?	negative escalopes                                                                                                                          	 negative escalopes panées           
Les prix des boissons et des desserts sont très élevés (4,5 euros pour une canette de coca..).	negative boissons | negative desserts | negative canette de coca                                                                                                              	 negative boissons | negative desserts | negative canette de coca.
En bref la nourriture n'est pas extraordinaire, peut être même préparée longtemps à l'avance?	negative nourriture                                                                                                                          	 neutrale nourriture
Je ne recommanderai pas ce restaurant et n'y retournerai pas!	negative restaurant                                                                                                                            	 negative restaurant  
Ambiance très parisienne, très m'as tu vu!	negative Ambiance                                                                                                                           	 positive Ambiance  
serveuse pas souriante et peu accueillante.	negative serveuse                                                                                                                           	 negative serveuse 
Cuisine très moyenne, poulet version crêpe archi sec avec une poignée de haricots et tout cela pour un prix exorbitant!	negative Cuisine | negative poulet | negative poulet                                                                                                                  	 negative Cuisine | negative poulet version crêge archi sec | negative haricots
Le sandwich club n'a rien de spécial et le plat vietnamien très sec sans aucune sauce.	negative sandwich club | negative plat vietnamien                                                                                                                   	 negative sandwich club | negative plat vietnamien        
La décoration est un peu surchargée mais cela fait le charme de l'endroit.	neutral décoration                                                                                                                            	 negative décoration | positive endroit            
J'y suis allée par hasard avec des amis un soir pour l'apéro et je suis revenue y déjeuner car la formule tapas à 15 € m'avait bien plu.	positive formule tapas                                                                                                                            	 positive formule tapas | positive tapas              
Vous ne trouverez pas les pseudos tapas que l'on trouve à toutes les terrasses mais uniquement les vraies recettes espagnoles : rabas de calamars, croquetas de jamon y queso, pain à la tomate, croquetas de bacalao, tortilla, serrano, piquillos, calamars à l'encre, artichauts au jambon...	positive recettes espagnoles | positive recettes espagnoles                                                                                                              	 positive tapas espagnoles : rabas de calamars | positive croquetas de jamon y queso | positive pain à la tomate | positive croquetas de bacalao | positive tortilla | positive piquillos | positive artichauts au jambon
Sans parler de la sangria tout simplement délicieuse!	positive sangria                                                                                                                            	 positive sangria                                                          
Les desserts sont à l'image du reste : crème catalane, gâteau basque, fromage de brebis et confiture de cerises noires...	positive desserts                                                                                                                            	 positive desserts | positive crème catalane | positive gâteau basque | positive fromage de brebis | positive confiture de cerises noires                             
Les serveurs ne parlent pas tous très bien français mais ils sont très gentils (et leur accent espagnol renforce le côté authentique de l'endroit).	positive serveurs | positive endroit                                                                                                                        	 positive serveurs | positive accent espagnol                                                    
15€ pour une salade composée avec deux ingrédients : de la salade verte et 2 tranches de saumon fumé.	negative salade composée | negative salade composée                                                                                                                  	 negative salade composée avec deux ingrédients : de la salade verte et 2 tranches de saumon fumé
Hésitant au départ sur le choix du lieu, un bon verre de vin, des bons tapas de qualité engloutis,nous avons au final passé une excellente soirée avec nos amis.	positive tapas | positive verre de vin | positive lieu                                                                                                                   	 positive verre de vin | positive tapas de qualité                    
"Le Patron à l'air RUSTRE au départ, mais il joue un ""jeu"" et est super prévenant avec ses clients!"	negative Patron                                                                                                                            	 negative Patron | positive Patron                        
Un lieu simple ou passer une agréable soirée!	positive lieu                                                                                                                            	 positive lieu                           
Mais aucune qualité dans l'assiette, aucune présentation, on se serait cru à un repas que l'on fait chez soi.	negative assiette | negative assiette                                                                                                                      	 negative assiette | negative présentation       
De plus, parmi nos assiettes, nous avions un panel de morceaux de viande du plus petit ou plus gros!	negative assiettes                                                                                                                           	 negative morceaux de viande        
Côté saumon, il était cru, on l'a signalé, la serveuse prend les 3 assiettes concernées, revient et nous demande à qui étaient les assiettes?!!	negative saumon | negative serveuse                                                                                                                      	 negative saumon | negative serveuse       
De plus, recuit au micro onde!!! avec des haricots verts cuit vapeur, pas revenus, sans sauce, bref lamentable!	negative haricots verts                                                                                                                        	 negative haricots verts cuit vapeur | negative sauce
Le gâteau: un fraisier, nous avions cherché les fraises et écœurant trop de crème.	negative fraisier                                                                                                                          	 negative gâteau               
Heureusement les cocktails sans alcool et les cafés étaient bons et offerts, mais nous aurions préféré les payer et avoir quelque chose de mieux dans l'assiette.Un minimum de présentation, c'est un rien qui peut faire la différence à l’œil!	positive cafés | negative assiette | positive cocktails sans alcool                                                                                                                	 positive cocktails sans alcool | positive cafés | positive assiette      
La serveuse était très agréable et souriante, juste petit souci avec la prise des 3 assiettes pour faire recuire les saumons mais sinon rien à lui reprocher.	positive serveuse                                                                                                                            	 positive serveuse | negative prise des 3 assiettes pour faire reculer les saumons
Situé entre les arênes et la cour carrée, ce restaurant ne désemplit pas.	neutral restaurant                                                                                                                             	 positive restaurant                  
Très curieux car la nourriture n'a rien de sensationnel, je me suis brûlé le palais avec des nems.	negative nourriture                                                                                                                          	 negative nourriture         
Le riz cantonais était sec et j'ai attendu pendant plus de 20 mns 2 malheureuses boules de glace.	negative riz cantonais                                                                                                                         	 negative riz cantonais | negative boules de glace
Petite cuisine de petite qualité et pas fait maison.	negative cuisine                                                                                                                            	 negative cuisine | negative cuisine       
Nous aurions aimé un meilleure repas moins speedé et avec plus de gout.	negative repas                                                                                                                            	 negative repas | negative repas       
L’accueil laisse à penser que tout va bien se passer mais rien ne se passe.	negative accueil                                                                                                                           	 negative accueil   
Service rapide et de qualité.	positive Service                                                                                                                             	 positive Service     
Fraîcheur des produits, de belles présentations.	positive produits                                                                                                                            	 positive produits | positive présentations
Adresse à retenir.	positive Adresse                                                                                                                            	 positive Adresse    
dans une petite rue de Menton, un restaurant pas très grand par la taille mais vraiment remarquable par la qualité de sa cuisine : les raviolis aux fruits de mer, les gambes ( décortiquées, un plus pour le plaisir... ) le turbot pour 2, présenté avant cuisson, les anchois sur lit de roquette...enfin si vous êtes un inconditionnel de la viande, l'agneau rosé était parfait... accueil sympa,	neutral restaurant | positive cuisine | positive gambes | positive agneau rosé | positive accueil | positive vins de sicile | neutral entrées | neutral turbot pour 2                                                                                         	 positive cuisine | positive raviolis aux fruits de mer | positive gambes sur lit de roquette | positive agneau rosé
Endroit sympa en plein centre touristique.	positive Endroit                                                                                                                            	 positive endroit                         
Nourriture classique de Menton.	neutral Nourriture                                                                                                                           	 positive Menton                         
Superbe cadre si on mange dehors.	positive cadre                                                                                                                            	 positive cadre                         
Accueil des plus stériles, presque l'impression de déranger.	negative Accueil                                                                                                                            	 negative Accueil        
Nous commandons 2 pizza, d'aspect correcte mais baignant dans l'huile, ok nous sommes dans le sud donc nous passons outre.	negative pizza                                                                                                                            	 neutrale pizza | negative pizza    
Après dégustation c'est le drame, un cailloux dans la pizza de mon ami.	negative pizza                                                                                                                            	 negative pizza        
J'appel la serveuse pour me plaindre, aucune excuse, pour elle c'est normal car il s'agit de champignon frais et nous dit que la prochaine fois ils feront du congelé...	negative serveuse                                                                                                                           	 negative serveuse | negative champignon frais
Manifestement, nous derangeons la serveuse.	negative serveuse                                                                                                                           	 negative serveuse               
Le mojito est abominable, tiède, beaucoup trop sucré, citron balancé tel quel dans le verre...	negative mojito | negative mojito                                                                                                                      	 negative mojito | negative mojito          
Cuisine de saison avec des petites courgettes de pays excellentes accompagnées d'un magret cuit à la perfection.	positive Cuisine | positive courgettes | positive magret                                                                                                                    	 positive cuisine de saison | positive petites courgettes de pays | positive magret cuit
A recommander aux amateurs de bonne viande et de produits du terroir.	positive viande                                                                                                                            	 positive viande | positive produits du terroir        
Nous avons été déçu par le service.	negative service                                                                                                                            	 negative service        
Serveur dépassé alors que la terrasse n'était pas remplie.	negative Serveur                                                                                                                           	 negative Serveur | negative terrasse   
Très déçue par ce restaurant	negative restaurant                                                                                                                            	 negative restaurant        
Je conseille fortement le déjeuner en terrasse avec forfait spa.	positive terrasse                                                                                                                             	 positive déjeuner en terrasse avec forfait spa
Le serveur aux cheveux longs, brun, la trentaine, s'est empressé de me répondre d'un ton très méprisant qu'à chamonix l'eau est payante.	negative serveur                                                                                                                           	 negative serveur     
Un service parfait, très bonne table, vu la petite superficie du lieu, tout est bien.	positive service | positive lieu | positive table                                                                                                                      	 positive service | positive table | positive lieu
il faut y aller, pour conclure l'extraordinaire lieu montagnard à 3842 m.	positive lieu                                                                                                                            	 positive lieu montagnard   
Encore bravo pour le chef,et son équipe.	positive équipe                                                                                                                            	 positive chef | positive équipe   
Le cadre est joli, les serveuses sympa mais peu disponibles.	positive serveuses | positive cadre | negative serveuses                                                                                                                   	 positive cadre | negative serveuses          
Les viandes étaient bonnes mais un peu juste en quantités à mon goût.	positive viandes | neutral viandes                                                                                                                      	 positive viandes | negative viandes        
Les sauces mayonnaises maison étaient bonnes mais sans plus, elles manquaient un peu de saveurs.	neutral sauces mayonnaises                                                                                                                        	 positive sauces mayonnaises maison | negative sauces mayonnaises maison
La tartiflette était correcte.	neutral tartiflette                                                                                                                           	 positive tartiflette              
Bref, le repas n'était pas mauvais mais je n'ai pas été emballé.	neutral repas                                                                                                                             	 neutral repas | negative repas            
Divin!! Endroit joli nourriture délicieuse patron tres sympa et une bonne bouteille avec Ca!!	positive nourriture | positive Endroit | positive patron | positive bouteille                                                                                                                	 positive endroit | positive nourriture | positive patron | positive bouteille avec Ca
Un très bon moment passé dans ce restaurant.	positive restaurant                                                                                                                             	 positive restaurant                
Les plats que nous avons choisis étaient très copieux.	positive plats                                                                                                                             	 positive plats                
C'est comme si les produits nobles avaient disparu.	negative produits                                                                                                                           	 negative produits                       
De l'accueil à la cuisine tout est bas de gamme, heureusement le rabatteur est là pour piéger les touristes qui passent par là.	negative accueil | negative cuisine | negative rabatteur                                                                                                                  	 negative accueil | negative cuisine | negative rabatteur              
tres bon produit hamburger et frites maison un regal le patron super cool et un prix tres raisonnable	positive produit | positive hamburger | positive frites | positive patron                                                                                                                  	 positive hamburger | positive frites maison | positive patron                
bel emplacement pour ce restaurant mais quelle deception.... un serveur qui ne parle pas et qui vous sert sans rien annoncer coté cuisine rien de mieux assiettes très peu garni et qualité bof assiette de charcuterie basique le plat andouillette et pomme de terre que je deconseille fortement..... bref passez votre chemin.....	positive emplacement | negative restaurant | negative serveur | negative cuisine | negative assiettes | negative assiettes | neutral assiette de charcuterie | negative andouillette et pomme de terre                                                                                  	 negative serveur | negative assiettes de charcuterie basique | negative plat andouillette et pomme de terre
Une carte hyper simple mais une serveuse complètement perdue.	neutral carte | negative serveuse                                                                                                                        	 positive carte | negative serveuse
Des erreurs de prise de commande et une patronne qui refuse de changer les plats sous prétexte qu'elle ne va pas jeter l'assiette et qu'elle l'a fait avec amour mdr.	negative patronne                                                                                                                           	 negative patronne   
Apparemment il n'est pas question de perdre de l'argent dans ce restaurant et elle invente des prétextes encensés pour faire passer la pilule.Toute la salle est de mon avis et en colère.	negative restaurant                                                                                                                            	 negative restaurant | negative restaurant
"Je vous passe les ""prises de bec"" avec la patronne pour lui faire comprendre que sa réaction est intolérable et non commerçante."	negative patronne                                                                                                                           	 negative patronne   
Restaurant a ne pas conseiller et surtout à bannir afin d’éviter que la profession de la restaurant ne soit bafouée par ce genre de pseudo restaurateur qui devrait penser à changer de métier.	negative Restaurant | negative restaurateur                                                                                                                       	 negative Restaurant | negative restaurateur              
Un cadre très rose mais agréable pour des dîners en couple ou entre amis.	positive cadre                                                                                                                            	 positive cadre                   
Des assiettes très bien présentées et un bon accueil avec des personnes souriantes.	positive assiettes | positive accueil                                                                                                                        	 positive assiettes | positive accueil | positive personnes           
Accueil chaleureux, arrière salle voûtée magnifique (ancien rempart de la ville), très bonne cuisine, grillades au feu de bois casiement sous nos yeux, produits de qualité et prix raisonnable.	positive Accueil | positive arrière salle | positive cuisine | positive produits | positive grillades au feu de bois                                                                                                        	 positive Accueil | positive arrière salle voûtée | positive cuisine | positive grillades au feu de bois
l'accueil est agréable; la cuisine correcte, les prix raisonnables, bref c'est bien mais est-ce le nombre de gens, la salle,... il manque un petit quelque chose pour s'enthousiasmer.	positive accueil | neutral cuisine | negative salle                                                                                                                    	 positive accueil | positive cuisine | positive salle | negative accueil    
Nous y sommes, plat du jour tagliatelles aux fruits de mer, produits frais mais certains caoutchouteux, le service et l'accueil très moyen, saint Jacques bonnes mais riz très sec, bref certainement mieux ailleurs!	positive produits | negative service | negative accueil | positive saint Jacques | negative riz | negative produits                                                                                                    	 negative tagliatelles aux fruits de mer | negative service | negative rice
Nous avons découvert avec par hasard ce cabanon de plage et ce fut une excellente surprise: un accueil des plus chaleureux, des plats très corrects, une ambiance lounge-beach pas surfaite.	positive cabanon de plage | positive accueil | positive plats | positive ambiance                                                                                                             	 positive accueil | positive plats | positive ambiance lounge-beach      
On voit que l'équipe prend du plaisir à travailler dans ce lieu magique.	positive équipe | positive lieu                                                                                                                        	 positive lieu                
Très bonne table dans une ruelle derrière le port donc sans avoir le défilé des touristes qui regardent votre assiette.	positive table                                                                                                                             	 positive table | positive assiette          
On trouve dans ce restaurant une cuisine provençale parfumée, présentée très joliment et en quantité généreuse.	positive cuisine provençale | positive cuisine provençale                                                                                                                    	 positive cuisine provençale parfumée | positive cuisine provençale parfumée 
Le service est très correct Nous avons passé un très bon moment et nous vous recommandons l'endroit.	positive service | positive endroit                                                                                                                         	 positive service | positive endroit          
J'ai mangé avec des amis dans ce restaurant et je trouve que la qualité des produits se sont serieusement dégradé, la salade d'accueil comporte 2 feuilles, le plat principal et le dessert sont baclés dans la présentation.	negative produits | negative salade d'accueil | negative plat principal | negative dessert                                                                                                          	 negative salade d'accueil | negative plat principal | negative dessert
De plus, l'accueil de la part du patron est froid contrairement aux serveurs très gentils.	negative accueil | positive serveurs                                                                                                                       	 negative accueil de la part du patron | positive serveurs
Les serveuses étaient plutôts agréables mais pas une cacahuète ou une olive à l'heure de l'apéritif malheureusement, pas d'assiette apéritive non plus.	positive serveuses                                                                                                                            	 positive serveuses | negative assiette apéritive 
Incompréhensible pour un bar restaurant...	negative bar restaurant                                                                                                                           	 negative bar restaurant         
Comment peut-on appeler ça un restaurant?	negative restaurant                                                                                                                            	 negative restaurant          
Un accueil et un service déplorables, une cuisine médiocre n'ayant rien à envier au manque de fraîcheur du buffet notamment.	negative accueil | negative service | negative cuisine | negative buffet                                                                                                              	 negative accueil | negative service | negative cuisine | negative buffet
Dans cet établissement je me suis sentie chez moi ayant eu un restaurant du même genre.	positive établissement                                                                                                                            	 positive établissement              
Une cuisine savoureuse faite avec amour, j'y retourne dés que je peux pour moi c'est un vrai restaurant	positive cuisine | positive restaurant                                                                                                                          	 positive cuisine savoureuse | positive restaurant          
La carte est très large, de bons plats chauds et bons!	positive carte | positive plats                                                                                                                          	 positive carte | positive plats chauds | positive plats       
Trois cocottes de moules marinières arrivent à table, à l'ouverture, les moules de l'une d'entre elles sont recouvertes de tomates et pas les autres.	neutral moules                                                                                                                            	 negative cocottes de moules marinières 
Certaines moules sont trop cuites d'autres pas assez.	negative moules                                                                                                                           	 negative moules       
Les frites ont goût d'huile.	negative frites                                                                                                                           	 negative frites       
Au milieu de ma cocotte de moule marinière j'ai la désagréable surprise de trouver un demi citron, peau comprise, déchiqueté.	negative cocotte de moule marinière                                                                                                                      	 negative demi citron | negative moule marinière
La note qui nous est présentée est défalquée d'une cocotte alors que plus personne ne souhaite manger ces moules douteuses.	negative moules                                                                                                                           	 negative moules  
Nous nous ferons ensuite de nouveau insulter par le responsable avant qu'il accepte d'encaisser nos boissons et de nous laisser partir.	negative responsable                                                                                                                           	 negative responsable  
Nous ne nous attendions pas à de la grande cuisine dans cet endroit très touristique mais nous aurions néanmoins apprécié de pouvoir déjeuner sans mettre notre santé en danger et sans nous faire manquer de respect par dessus le marché!	negative endroit                                                                                                                           	 positive cuisine | positive endroit
Premiere fois dans ce restaurant dont on nous disait pourtant du bien.	negative restaurant                                                                                                                            	 positive restaurant    
Les plats proposés sont originaux, les saveurs intéréssantes mais le rapport qualité prix n'est pas au rendez vous.	positive plats                                                                                                                             	 positive plats | positive saveurs | negative rapport qualité prix
18,50 € un risotto, où j'ai cherché du saumon fumé pourtant annoncé, que je n'ai hélas pas trouvé, c'est bien trop cher aussi bon soit il.	negative risotto | negative risotto                                                                                                                      	 negative risotto | negative saumon fumé 
On a payé le cadre coloré et le port touristique de la Cotinière.	neutral cadre | neutral port touristique                                                                                                                       	 positive cadre | positive port touristique    
Si il n'y avait que cela ça aurait pu aller mais le service a été catastrophique.	negative service                                                                                                                            	 negative service         
La prise de commande par le patron est venue bien longtemps après la fin de l'apéritif, et le pire a été le service du vin quand nous avions presque fini notre plat.	negative patron | negative service du vin                                                                                                                      	 negative patron | negative service du vin
Malgré une cuisine gouteuse nous n'y retournerons pas.	positive cuisine                                                                                                                             	 negative cuisine      
Restaurant très sympa.	positive Restaurant                                                                                                                             	 positive Restaurant       
Petite salle ambiance plage Oléronaise.	neutral ambiance                                                                                                                            	 positive ambiance plage Oléronaise 
Deco et tables raffinées (nappes et serviettes en tissus...).	positive Deco                                                                                                                             	 positive Deco | positive tables raffinées (nappes | positive serviettes en tissus)
Personnel très souriant et chaleureux.	positive Personnel                                                                                                                           	 positive Personnel                  
Menus un peu chers mais très bons.	neutral Menus | positive Menus                                                                                                                        	 negative Menus | positive Menus              
Cela dit pour du tout fait maison avec des produits frais de très bonne qualité cela reste très intéressant.	positive produits                                                                                                                            	 positive produits frais | positive produits frais           
Plats copieux et bien présentés.	positive Plats                                                                                                                            	 positive Plats | positive Plats 
Très bons, surtout les desserts (excellents).	positive desserts                                                                                                                            	 positive desserts | positive desserts 
Coctails très bons mais un peu cher pour la quantité (5/8€)	positive Coctails | neutral Coctails | negative Coctails                                                                                                                   	 positive Coctails | negative Coctails
Restaurant ouvert hors saison.	neutral Restaurant                                                                                                                             	 negative Restaurant     
Terrasse à l'ombre des arbres très agréable, jolies assiettes, poissons bien préparés, belle décoration et service sympathique.	positive Terrasse | positive assiettes | positive poissons | positive décoration | positive service                                                                                                              	 positive Terrasse | positive assiettes | positive poissons | positive décoration | positive service
L'adresse est trompeuse, le restaurant n'est pas à Castelnaudary mais dans un petit village juste après.	neutral restaurant                                                                                                                             	 negative adresse | positive restaurant           
Appelez la patronne pour savoir, elle est adorable.	positive patronne                                                                                                                            	 positive patronne              
Et faites le détour, pour un cassoulet top et généreux.	positive cassoulet | positive cassoulet                                                                                                                      	 positive cassoulet | positive cassoulet        
Avec un petit verre de Minervois.	positive verre                                                                                                                            	 positive verre de Minervois    
ET un petit fois gras juste avant.	positive fois gras                                                                                                                           	 negative fois gras juste avant    
accueil sympathique, cuisine de très bonne qualité mais parfois la main est un peu lourde sur le sel, petit problème rectifié depuis.	positive accueil | positive cuisine                                                                                                                         	 positive accueil | positive cuisine | negative main 
"Un cassoulet franchement ""infect"", qui fait honte au nom porté par le restaurant et pour un soi-disant ""restaurant traditionnel servant une cuisine de Chef faite à partir de produit brut"" (sic)... qualifié de ""Cassoulet fait Maison""!."	negative cassoulet | negative cuisine                                                                                                                      	 negative cassoulet | negative cuisine de Chef
A éviter tant pour la cuisine que pour le service.	negative cuisine | negative service                                                                                                                        	 negative cuisine | negative service                  
Repas totalement décevant et cher!	negative Repas | negative Repas                                                                                                                      	 negative Repas | negative Repas                
Pour deux entrées, deux plats et deux desserts à la carte avec une bouteille de vin nous avons trouvé le repas assez cher pour Castelnaudary (92€).	negative repas                                                                                                                            	 negative repas | negative entrées | negative plats | negative desserts | negative bouteille de vin
En plus tout provenait de conserves ou il s'agissait de plat surgelés...	negative plat                                                                                                                            	 negative conserves | negative plat surgelés               
"Je déconseille totalement ce ""restaurant""."	negative restaurant                                                                                                                            	 negative restaurant       
Service gentil.	positive Service                                                                                                                             	 positive Service        
Pizza honnêtes mais éviter le tiramisu.	neutral Pizza | negative tiramisu                                                                                                                      	 negative Pizza | negative tiramisu
Attention la bière est italienne...	negative bière                                                                                                                           	 negative bière      
Un lieu à connaitre!.	positive lieu                                                                                                                            	 positive lieu       
Cuisine excellente avec de la recherche.	positive Cuisine | positive Cuisine                                                                                                                          	 positive Cuisine | positive recherche     
Bravo pour le chef et la patissière ; nous reviendrons pour la langue de Bœuf!	positive langue de Bœuf                                                                                                                        	 positive chef | positive patisière   
Très bonne cuisine traditionnelle dans un endroit typique.	positive cuisine traditionnelle                                                                                                                           	 positive cuisine traditionnelle | positive endroit typique
Dommage pour ce petit restaurant sympa.	positive restaurant                                                                                                                             	 negative restaurant     
Le repas est juste indécent!	negative repas                                                                                                                            	 negative repas     
Rien de bon même la pomme de terre n'était pas cuite!	negative pomme de terre                                                                                                                         	 negative pomme de terre  
Ne surtout pas y aller pour bien manger, par contre on se laisse bien embarquer dans l'ambiance de ces années là.	positive ambiance                                                                                                                            	 negative manger | positive ambiance
